{
  "width": 27,
  "height": 7,
  "name": "Shadow Abyss",
  "mapData": [
    "+++++++++++++++++++++++++++",
    "+   H                 G   +",
    "+             K           +",
    "+P                        +",
    "+            K        M   +",
    "+   K    K                +",
    "+++++++++++++++++++++++++++"
  ]
}