{
  "width": 27,
  "height": 7,
  "name": "Town",
  "mapData": [
    "+++++++++++++++++++++++++++",
    "+   H              E      +",
    "+   P                     +",
    "+                         +",
    "+                     M   +",
    "+                         +",
    "+++++++++++++++++++++++++++"
  ]
}